11111111111111111111
1 <  @   >         1
11111111111        1
1         1        1
1   1#11111        1
1    H             1
1    H<    @  >    1
1   [====#=====]   1
1        H         1
1        H         1
1P       H         1
11111111111111111111
